111111111
100100001
101010101
101C010E1
101010101
101P00001
100111111
100000001
111111111