11111111111111111111
1C0C0000000000000001
10000000000000000001
10000000000000000001
10000000000000000001
10000000000010000001
100000000000E1000001
10000000000010P00001
10000000000000000001
10000000000000000001
10000000000000000001
10000000000000000001
10000000000000000001
10000000000000000001
10000000000000000001
10000000000000C00011
100000000000000000C1
11111111111111111111