11111111
10000001
10E00P01
100C0001
11111111