11111111111111111111
10000C00000000000001
100000000C0000000001
10000000000000000001
100000000C0000000001
10000000000000000001
100000000000E0000001
10000000000000P00001
10000000000000000001
10000000000000000001
10000000000000000001
10000000000000000001
10000000000000000001
1000C000000000C00001
10000000000000000001
10000000000000000C01
10000C0C000000000001
11111111111111111111